26x60
0,0,0,0,0,0,0,19,0,0,0,0,0,0,0,0,0,0,0,0,0,0,0,0,0,0
0,0,0,0,0,0,18,20,0,0,0,0,0,0,0,0,0,1,0,1,0,0,0,0,0,0
0,0,0,0,0,19,18,22,35,0,0,0,0,0,0,0,1,1,1,0,0,0,0,0,0,0
0,0,0,0,18,28,22,22,20,0,0,0,0,0,0,0,0,1,0,0,0,0,0,0,0,0
0,0,0,0,18,22,22,22,22,38,0,0,0,0,0,0,0,0,0,0,0,0,0,0,0,0
0,0,0,36,22,22,22,22,26,0,0,0,0,1,0,0,0,0,0,0,0,0,0,0,0,0
0,0,0,0,24,22,22,22,41,0,0,0,1,1,0,0,0,1,1,0,0,0,0,0,0,0
0,19,0,0,24,22,22,26,0,0,0,0,0,1,0,0,1,1,0,0,0,0,0,0,0,0
0,18,35,0,0,30,22,29,0,0,0,0,1,1,0,0,1,1,1,0,0,0,0,0,0,0
18,22,20,0,21,22,42,23,0,31,0,0,0,0,0,0,0,0,0,0,0,0,0,0,0,0
21,22,22,23,0,24,26,25,0,0,0,0,1,0,0,0,0,0,0,0,0,0,0,0,0,0
30,22,41,0,0,40,0,0,0,0,0,0,0,0,0,0,0,0,0,0,0,0,0,0,0,0
21,22,26,0,0,0,0,0,0,0,0,0,0,0,0,0,0,0,0,0,0,0,0,0,0,0
24,26,0,0,1,0,0,0,0,0,0,0,0,0,0,0,0,0,0,0,0,0,0,0,0,0
0,40,0,1,1,0,1,1,1,0,0,0,0,0,4,0,0,0,0,0,0,0,0,0,0,0
0,0,0,0,0,0,1,0,1,0,0,0,0,3,5,0,0,0,0,0,0,0,0,0,0,0
0,0,0,1,0,0,0,0,0,0,0,0,4,3,7,8,0,0,0,0,0,0,0,0,0,0
0,0,46,0,0,1,1,1,0,0,0,3,13,7,11,0,0,0,0,0,0,0,0,0,0,0
0,0,0,0,1,1,1,0,0,0,0,6,7,7,11,0,0,0,0,0,0,0,0,0,0,0
0,0,0,0,0,1,0,0,0,0,0,9,12,11,0,0,0,0,0,0,0,0,0,0,0,0
0,0,0,0,0,0,16,0,0,0,0,0,10,10,0,0,0,0,0,0,0,0,0,0,0,0
0,0,1,0,0,0,4,0,0,0,0,0,0,0,0,0,0,0,0,0,0,0,0,0,0,0
0,1,1,1,0,4,6,5,0,0,0,0,0,0,0,0,0,0,0,0,0,0,0,0,0,0
0,0,0,0,3,5,15,8,0,0,0,0,19,0,0,0,0,0,0,0,1,0,0,0,0,0
0,0,0,0,3,7,43,14,0,0,0,0,21,20,0,0,0,0,0,1,1,1,0,1,1,0
0,0,0,3,7,7,7,8,0,0,19,0,30,20,0,0,0,0,0,0,1,0,0,1,0,0
0,0,0,6,7,7,7,11,0,0,18,20,33,22,20,0,0,0,0,0,0,0,0,0,0,0
0,0,0,9,12,7,11,0,0,21,22,28,22,22,23,0,0,0,1,1,0,0,1,0,0,0
0,0,0,0,10,9,11,0,0,0,30,22,22,22,26,0,0,0,0,0,0,0,1,0,0,0
0,0,0,0,0,10,0,0,0,21,22,22,27,26,0,0,0,0,0,16,0,0,0,0,0,0
0,0,0,0,0,0,0,0,0,0,24,22,41,25,0,0,0,0,0,0,0,0,0,4,0,0
0,0,0,0,0,0,0,0,0,0,24,29,0,0,0,0,0,0,0,0,0,4,3,8,0,0
0,0,0,0,0,0,0,0,0,0,0,24,20,0,0,0,0,0,0,0,0,3,13,14,0,0
0,0,0,0,0,0,0,0,0,0,0,24,23,0,0,0,0,0,0,0,6,12,7,5,0,0
0,0,0,0,0,0,0,0,0,19,0,0,25,0,0,0,0,0,0,0,0,10,9,7,5,0
0,0,0,0,0,0,0,0,21,23,0,0,0,0,0,0,0,0,0,0,0,0,9,7,8,0
0,0,0,0,0,0,0,0,0,25,0,0,0,0,0,0,0,0,0,0,0,0,0,9,11,0
0,0,0,0,0,0,0,0,0,0,0,0,0,0,0,0,0,0,0,0,0,0,0,10,0,0
0,0,0,0,0,0,0,0,0,0,0,0,0,0,0,0,0,0,0,1,1,1,0,0,0,0
0,0,0,0,0,0,0,0,0,0,0,0,0,4,0,0,0,0,0,0,0,1,0,0,0,0
0,0,0,0,0,0,0,0,0,0,0,0,0,3,5,0,0,0,46,0,0,0,0,0,0,0
0,0,0,0,0,0,0,0,0,0,0,0,3,7,5,0,0,0,0,0,0,0,0,0,0,0
0,0,0,0,0,0,0,0,0,0,0,0,3,12,7,8,0,0,1,1,1,1,0,0,0,0
0,0,0,1,0,0,0,0,0,0,0,3,11,9,14,0,0,0,0,0,1,0,0,0,0,0
0,0,1,0,0,0,0,0,0,0,0,3,14,0,15,8,0,0,0,0,0,0,19,0,0,0
0,0,0,0,0,0,0,0,0,0,6,7,5,3,11,0,1,1,0,0,0,33,20,0,0,0
0,0,0,0,1,0,0,0,0,0,0,9,7,13,11,0,1,0,0,0,19,18,22,35,0,0
0,0,0,0,1,0,0,0,0,0,0,9,7,11,0,0,0,0,0,18,28,22,22,20,0,0
0,1,0,0,1,1,0,0,0,0,0,0,9,14,0,0,0,0,0,18,22,22,22,22,38,0
0,1,1,0,0,0,0,0,0,0,0,0,9,8,0,0,0,0,36,22,22,22,22,26,0,0
0,1,0,0,0,0,0,0,0,0,0,0,0,10,1,0,0,0,0,24,22,22,22,41,0,0
0,0,0,0,1,0,0,16,0,0,0,0,0,0,0,0,19,0,0,24,22,22,26,0,0,0
0,0,0,1,1,0,0,0,0,0,0,0,1,0,0,0,18,35,0,0,30,22,29,0,0,0
0,0,1,0,0,0,4,0,0,0,0,1,1,0,0,33,22,20,0,21,22,27,23,0,31,0
0,0,0,0,0,0,6,8,0,0,0,0,0,0,0,21,22,22,23,0,39,26,25,0,0,0
0,0,0,0,0,0,10,0,0,0,0,0,0,0,1,30,22,41,0,0,25,0,0,0,0,0
0,0,0,0,0,0,0,0,0,0,0,1,1,0,1,21,22,26,0,0,0,0,0,0,0,0
0,0,0,0,0,0,0,0,0,0,0,0,1,0,0,24,26,0,0,0,0,0,0,0,0,0
0,0,0,0,0,0,0,0,0,0,0,0,0,0,0,0,25,0,0,0,0,0,0,0,0,0
0,0,0,0,0,0,0,0,0,0,0,0,0,0,0,0,0,0,0,0,0,0,0,0,0,0

spawn 5,6
spawn 21,50
worm 25,0
worm 0,59
